Japanese Verb Conjugation

Click on each verb to download conjugation infographic and see example sentences.

JLPT N5 Verb List

歩く (aruku): to walk

遊ぶ (asobu): to play

会う (au): to meet

出す (dasu): to take out

出る (deru): to leave

選ぶ (erabu): to choose

吹く (fuku): to blow

降る (furu): to fall (rain)

入る (hairu): to enter

話す (hanasu): to speak

張る (haru): to stick

働く (hataraku): to work

引く (hiku): to pull

行く (iku): to go

入れる (ireru): to put in

言う (iu): to say

帰る (kaeru): to come back

返す (kaesu): to return (something)

書く (kaku): to write

借りる (kariru): to borrow

貸す (kasu): to lend

消す (kesu): to turn off

買う (kau): to buy

消える (kieru): to vanish

聞く (kiku): to listen

着る (kiru): to wear

切る (kiru): to cut

答える (kotaeru): to answer

来る (kuru): to come

待つ (matsu): to wait

磨く (migaku): to polish

A conjugation infographic like this is available to download for all verbs. Click on each verb to find the download link.

見る (miru): to look

見せる (miseru): to show

持つ (motsu): to carry

無くす (nakusu): to lose

並ぶ (narabu): to line up

寝る (neru): to sleep

飲む (nomu): to drink

脱ぐ (nugu): to take off (clothes)

覚える (oboeru): to remember

起きる (okiru): to get up

置く (oku): to put

思う (omou): to think

教える (oshieru): to teach

押す (osu): to push

終わる (owaru): to end

泳ぐ (oyogu): to swim

閉める (shimeru): to close

死ぬ (shinu): to die

知る (shiru): to know

住む (sumu): to live

吸う (suu): to smoke

座る (suwaru): to sit

食べる (taberu): to eat

頼む (tanomu): to request

立つ (tatsu): to stand

飛ぶ (tobu): to fly

取る (toru): to take

使う (tsukau): to use

作る (tsukuru): to make

売る (uru): to sell

分かる (wakaru): to understand

忘れる (wasureru): to forget

渡る (wataru): to cross over

渡す (watasu): to hand over

休む (yasumu): to rest

呼ぶ (yobu): to call

読む (yomu): to read

JLPT N4 Verb List

上る (agaru): to go up

合う (au): to face

増える (fueru): to increase

払う (harau): to pay

開く (hiraku): to open

褒める (homeru): to praise

考える (kangaeru): to think

通う (kayou): to commute

飾る (kazaru): to decorate

壊す (kowasu): to break

回る (mawaru): to turn

向かう (mukau): to face

鳴る (naru): to ring

眠る (nemuru): to sleep

落ちる (ochiru): to fall

踊る (odoru): to dance

行う (okonau): to perform

起こす (okosu): to cause

落とす (otosu): to drop

触る (sawaru): to touch

叱る (shikaru): to scold

倒れる (taoreru): to collapse

建てる (tateru): to build

通る (tooru): to go through

捕まえる (tsukamaeru): to catch

包む (tsutsumu): to wrap

続ける (tsuzukeru): to continue

続く (tsuzuku): to continue

動く (ugoku): to move

受ける (ukeru): to receive

打つ (utsu): to hit

移る (utsuru): to move

焼く (yaku): to grill

汚れる (yogoreru): to get dirty

JLPT N3 Verb List

戦う (tatakau): to fight

This page is being updated.

If you find any error in this post please don't hesitate to 
contact me
.

If you have any questions please check the F.A.Q section.

If you find this post useful, please share it with your friends!

Don't forget to subscribe to JTest4You's Youtube channel! New videos every week!

If you find this website useful, please consider becoming a patron! You'll have access to exclusive resources!